############
#       O  #
#  XXP  ####
#        ###
#######X   #
#    # X # #
#   # O    #
#          #
#       O  #
# #        #
############